111111111111111111111111111111
100000000000000000C00000000001
101111111111111111111111111101
1C1111111111111111111111111101
101111111111111111111111111101
1011111111111111111111111111C1
101111111111111111111111111101
101111111111111111111111111101
101111111111111111111111111101
101111111111111111111111111101
101111111111111111111111111101
101111111111111111111111111101
1P00000000C1111111111111111101
1011111111111111111111111111E1
111111111111111111111111111111
