1111111111111111111111111111111111111
1P000000000000100000000000000000000C1
1111111000000010011111111111001111111
1000000000000000010000000000000000001
10000000011111100100010000000000000C1
1000000000000010010001000111111111111
1000111111111111110001000000000000001
1000000100000000010000000000000000001
100000C10000000000000C0000000000000E1
1111111111111111111111111111111111111
