1111111111111111111111111111
1C00000000000000000000000001
1111111111111011111111111101
1000000000000010000000000001
1011111111111110111111111101
1000000000C00P1E000000000001
1111111111111010111111111101
1000000000000010000000000001
10111111111111101111111111C1
1000000000000010000000000001
1111111111111111111111111111
